11111111101
10000000001
10000000001
11000000000
10000000001
11111111111
11111111111