111111111111
100100000101
100100100EP1
100000100111
10000C0001C1
111111111111