111111111111
10C1C00001C1
100100100EP1
1C0000100001
111111111111