11111111
1PC00001
10011001
1C01E001
11111111