111111111111
100000000001
111111E11111
11C100000001
10010010C0P1
100000100111
10000C0000C1
111111111111